Ber pests

Pests of national significance

Insect and mite pests

Fruit fly: carpomyia vesuviana costa (diptera: tephritidae) 
Fruit borer: meridarchis scyrodes meyr (lepidoptera: carposinidae) 
Green slug caterpillar: thosea sp. (lepidoptera: limacodidae) 
Mite: larvacarus transitans ewing (tetranychoidea: tenuipalpidae) 
Grey hairy caterpillar: thiacidas postica walker (lepidoptera: noctuidae) 

Diseases

Fruit rot: alternaria spp, phoma spp., colletotrichum spp., trichothecium spp, cladosporium spp.
Powdery mildew: oidium erysiphoides f. Sp. Ziziphi link 
Sooty mould: capnodium spp. 
Leaf spot: isariopsis clavispora berk. &amp; m.a. Curtis, cercospora spp, cladosporium spp link

Weeds

Broad leaf

Tick weed: cleome viscosa l. (capparidaceae) 
Coat buttons: tridax procumbens l.( asteraceae) 
Congress grass: parthenium hysterophorus l. Asteraceae 
Horse purslane: trainthema portulacastrum l. (aizoaceae) 
Lambs quarter: chenopodium album l (chenopodiaceae) 
Yellow sweet clover: melilotus indica (l.) all. (fabaceae) 
Spurge: euphorbia hirta l. (euphorbiaceae) 
Sorrel: reumex dentatus l. (acanthaceae) 
False amaranthus: digera arvensis forsk (amaranthaceae) 
Common cocklebur: xanthium strumarium l (euphorbiaceae) 
Puncture vine: l (zygophyllaceae) 
Creeping thistle: cirsium arvense (l.) scop. (asteraceae) 

Grassy weeds

Crabgrass: digitaria sanguinalis (l.) scop. Poaceae 
Yellow foxtail: setaria glauca (l.) p. Beauv. (poaceae) 
Bermuda grass: cynodon dactylon (l.) pers. Poaceae 
Torpedo grass: panicum repens l. (poaceae) 
Crows foot grass: dactyloctenium aegyptium (l.) willd (poaceae)

Sedge

Purple nutsedge: cyperus rotundus l. Cyperaceae 
Yellow nut sedge: cyperus esculentus l. Cyperaceae

Birds

Rose ringed parakeet: psittacula krameri scopoli (psittaciformes: psittaculidae) 

Pest of regional significance

Insect pests

Stone weevil: aubeus himalayanus voss (coleoptera: curculionidae) 
Bark eating caterpillar: indarbela quadrinotata walker (lepidoptera: metarbedelidae) 
Blue butterfly: tarucus theophrastus (fabricius) (lepidoptera: lycaenidae) 
Mite, eriophyes cernus mssee (acari: eriophyidae) 
Leaf miner: cameraria spp (lepidoptera: gracillariidae) 
Grey weevil: myllocerus undecimpustulatus marshall faust, m. Dentifer (fabricius), m. Blandus faust, amblyrrhinus poricolli schoenherr(coleoptera: curculionidae) 
Leaf eating caterpillar: euproctis spp (lepidoptera: erebidae)
Lac insect: kerria sp 

Diseases

Die back: phytophthora spp. 
Black fruit spot: alternaria alternata (fr.) keissl.

Ipm for ber

To know the ipm practices for ber, 

Source: ; 

