Betelivine pests

Pests of national significance in sunflower

Insect pests

Scale insect: lepidosaphes ulmi l. (hemiptera: diaspididae)
Betelvine bug: disphinctus politus walk. (hemiptera: miridae)
Mealy bug: ferrisia virgata cockerell (hemiptera: pseudococcidae)
Whitefly: dialeurodes pallida singh (hemiptera: aleyrodidae)
Red spider mites: tetranychus dufour (arachnida: tetranychidae)

Diseases

Leaf stem and foot rot: phytophthora spp.
Leaf spot or anthracanose: colletotrichum capsici (syd.) e.j. Butler &amp; bisby 
Sclerotial wilt or collar rots: sclerotium rolfsii sacc.
Powdery mildew: oidium piperis uppal, kamat &amp; patel
Bacterial leaf spot: xanthomonas campestris dowson nematodes

Nematodes:

Root-knot nematodes: meloidogyne incognita kofoid &amp; white (tylenchida: heteroderidae)
Reniform nematode: rotylenchulus reniformis linford and oliveira (tylenchida: hoplolaimidae)

Weeds

Broad leaf

Yellow sweet clover: melilotus indica (l.) all. (fabaceae)
Lambs quarter: chenopodium album l. (chenopodiaceae)
Creeping thistle: cirsium arvense (l.) scop (asteraceae)
Batthal: launea nudicaulis (l.) hook.f. (asteraceae)
Joyweed: alternenthera sessiles (l.) r.br. Ex dc. (amaranthaceae)
Creeping wood sorrel: oxalis corniculata l. (oxalidaceae)
Punarnava: boerhavia diffusa l. (nyctaginaceae)
Common puruselene: portulaee oleraceae l. (portulacaceae)
Common sorrel: rumex dentatus l. (polygonaceae)
Horse purslane: trianthema portulacastrurn l. (aizoaceae) grasses
Bermuda grass: cynodon dactylon l. (poaceae)
Blue grass: poa annua l. (poaceae) sedges 
Nut grass: cyperus rotundus l. (cyperaceae)
Flat sedge: cyperus iria l. (cyperaceae)

Rodents

Lesser bandicoot: bandicota bengalensis gray 
Black rat: rattus rattus l.

Pests of regional significance

Insect pests

Black fly: aleurocanthus woglumi singh (hemiptera: aleyrodidae)
Thrips: thrips tabaci l. (thysanoptera: thripidae)â€”
Aphids: aphis gossypii glover (hemiptera: aphididae)-west bengal 
Yellow mite: hetnyersonemus lotus -west bengal 

Diseases

Fusarium wilt: fusarium solani (mart.) sacc- west bengal

Nematodes

Stunt nematodes: tylenchorhynchus sp- bihar

Ipm for betelivine

To know the ipm practices for betelivine, 

Source: ; 

