Castor pests 

Pests of national significance

Insect pests

Tobacco caterpillar: spodoptera litura (fabricius) (lepidoptera: noctuidae)
Castor semilooper: achaea janata (linnaeus) (lepidoptera: noctuidae)
Shoot and capsule borer: conogethes (dichocrocis) punctiferalis (guen√©e) (lepidoptera: crambidae)

Diseases

Seedling blight: phytophthora colocasiae rac.
Alternaria blight: alternaria ricini (yoshii) hansford
Cercospora leaf spot: cercospora ricinella saccardo &amp; berlese
Powdery mildew: leveillula taurica (lev.) arm.
Wilt: fusarium oxysporum schlecht.

Weeds

Broad leaf

Pigweed: amaranthus viridis hook. F. (amaranthaceae)
Swine cress: coronopus didymus (l.) sm. (brassicaceae)
Black nightshade: solanum nigrum l. (solanaceae)
False amaranth: digera arvensis forssk. (amaranthaceae)

Grasses

Rabbit/crow foot grass: dactyloctenium aegyptium (l.) willd (poaceae)
Crabgrass: digiteria sanguinalis (l.) scop. (poaceae)
Burmuda grass: cynodon dactylon (poaceae)

Sedges

Purple nutsedge: cyperus rotundus l. (cyperaceae)
Flat sedge: cyperus iria l. (cyperaceae)

Pests of regional significance

Insect pests

Red headed hairy caterpillar: amsacta albistriga (walker), a. Mooreii. Butler (lepidoptera: arctiidae)
Bihar hairy caterpillar: spilosoma obliqua (walker) (lepidoptera: arctiidae)
Whitefly: trialeurodes ricini misra (hemiptera: aleyrodidae)
Thrips: retithrips siriacus, scirtothrips dorsalis hood (thysanoptera: thripidae)
Hairy caterpillars: euproctis fraternal moore (lepidoptera: lymantriidae)
Castor spiny caterpillar: ergolis (ariadne) merione ( cramer) (lepidoptera: nymphalidae)
Jassid: empoasca fl avescens fabricius (hemiptera: cicadellidae)
Tussock caterpillar: orgyia postica (walker) (lepidoptera: lymantriidae)
Castor slug: parasa lepida (cramer) (lepidoptera: limacodidae)
Serpentine leaf miner: liriomyza trifolii (burgess) (diptera: agromyziidae)

Disease

Collar rot: phytophthora spp.

Ipm for castor

To know the ipm practices for castor, 

Source: and 

