Coffee pests

Pests of major significance

Insect pests

White coffee stem borer: xylotrechus quadripes (chevrolat) (coleoptera: cerambycidae)
Coffee berry borer: hypothenemus hampei (ferrari) (coleoptera: curculionidae)
Coffee root mealybug: planococcus citri risso &amp; p. Lilacinus cockerell (hemiptera: pseudococcidae)
Shot hole borer: xylosandrus compactus eichhoff (coleoptera: curculionidae)
Brown scale: saissetia coffeae walker (hemiptera: coccidae)
Green scale: coccus viridis green (hemiptera: coccidae)
Cock chafers or white grubs: holotrichia spp. (coleoptera: melolonthidae)
Hairy caterpillars: eupterote spp. (lepidoptera: eupterotidae)
Coffee bean beetle: araecerus fasciculatus (de. Geer) (coleoptera: anthribidae)
Red coffee borer: zeuzera coffeae nietner (lepidoptera: cossidae)

Diseases

Coffee leaf rust: hemileia vastatrix (berk.)
Black rot or koleroga: corticium salmonicolor berk. &amp; broome

Root diseases

 brown root disease: fomes noxius corner
 red root disease: poria hypolateritia berk.
Sandavery root disease: fusarium oxysporum f.sp. Coffeae
Coffee trunk canker: ceratocystis fimbriata (ell. &amp; halst)
Berry blotch: cercospora coffeicola (cooke) stev. &amp; wellman
Brown eye spot disease: mycosphaerella coffeicola (cooke) stev. &amp; wellman
Coffee berry disease: colletotrichum kahawae waller &amp; bridge
Coffee wilt disease: fusarium xylarioides steyaert
 coffee bark disease: fusarium stilboides wollenw
Damping off/collar rot: pellicularia filamentosa (pat.) rogers, rhizoctonia solani kühn
Die back/ anthracnose: colletotrichum gloeosporioides mitchell.

Weeds

Broadleaf

Slender amaranth: amaranthus viridis l. (amaranthaceae)
 climbing dayflower: commelina diffusa l. (commelinaceae)
 puncture vine: tribulus terrestis l. (zygophyllaceae)
 purslane: portulaca oleracea l. (portulacaceae)
Garden spurge: euphorbia hirta l. (euphorbiaceae)

Grasses

Bermuda grass: cynodonn dactylon (l.) pers. (poaceae) 
 large crabgrass: digitaria sanguinalis l. (poaceae)
 purple top chloris: chloris barbata swartz (poaceae)

Sedges

 purple nutsedge: cyperus rotundus l. (cyperaceae)

Nematodes

Lesion nematode: pratylenchus coffeae goodey (tylenchida: pratylenchidae)
Root-knot nematode: meloidogyne incognita kofoid &amp; white (tylenchida: meloidogynidae)

Non insect pests

Mollusc: giant coffee snail: achatina fulica férussac
Rodents and bats.

Ipm for coffee

To know the ipm practices for coffee, 

Source: ; 

