Cucurbitaceous vegetable pests 

Pests of national significance

Insect and mite pests

Cucurbit fruit fly: bactrocera cucurbitae (big size), b. Tau, b. Dorsalis (medium size) (coquillett) (tephritidae: diptera) (assam, andaman and nicobar, delhi, kerala, maharashtra, rajasthan, tamil nadu) 
Pumpkin beetles: raphidopalpa foveicollis, aulacophora intermedia, a. Cincta (lucas) (chrysomelidae: coleoptera) (assam, madhya pradesh, uttar pradesh) 
Epilachna beetles: epilachna vigintioctopunctata, e. Dodecastigma (fabricius) (epilachninae: coccinellida: coleoptera) 
Serpentine leaf miner: liriomyza trifolii (burgess) (agromyzidae: diptera) (andhra pradesh, gujarat, karnataka, maharashtra, madhya pradesh, tamil nadu, uttar pradesh) 
Aphids: aphis gossypii (glover) (aphididae: hemiptera) (himachal pradesh, kerala, manipur, tamil nadu, uttar pradesh) 
Pumpkin leaf caterpillar: diaphania indica (saunders) (pyralidae: lepidoptera) (gujarat, karnataka, punjab, tamil nadu)

Diseases

Downy mildew: pseudoperonospora cubensis (berkeley &amp; m. A. Curtis) rostovzev (karnataka, maharashtra, punjab) 
Powdery mildew: erysiphe cichoracearum dc, sphaerotheca fuligenia (schltdl.) pollacci (haryana, karnataka, tamil nadu, uttar pradesh) 
Cucumber mosaic: cucumber mosaic virus (delhi, haryana, kerala, punjab, uttar pradesh) 
Fusarium wilt: fusarium oxysporum schlecht (delhi, karnataka, maharashtra, orissa, punjab, rajasthan, uttar pradesh)

Weeds

Broadleaf weeds

Pigweed: amaranthus viridis hook. F. 
Swine cress: coronopus didymus (l.) sm. 
Black nightshade: solanum nigrum l. 
Common purselane: portulaca oleracea l. 
False amaranth: digera arvensis forssk. 
Congress weed: parthenium histerophorous 
Witch weed: striga sp

Grassy weeds

Rabbit/crow foot grass: dactyloctenium aegyptium (l.) beauv. 
Crabgrass: digiteria sanguinalis (l.) willd. 
Barnyard grass: echinochloa crusgalli (l.) scop. Sedges 
Purple nutsedge: cyperus rotundus l. 
Flat sedge: cyperus iria l.

Broadleaf weeds

Lambâ€™s quarter: chenopodium album l. 
Scarlet pimpernel: anagallis arvensis l. 
Sweet clover: melilotus indica (l.) all. 
Fine leaf fumitory: fumaria parviflora lam. 
Corn spurry: spergula arvensis l. 

Grassy weeds

Blue grass: poa annua l. 
Canary grass: phalaris minor retz. 

Ipm for cucurbitaceous vegetable

To know the ipm practices for cucurbitaceous vegetable, .

Source: , 

