Custard apple pests

Pests of national significance

Insect and mite pests

Mealy bug: ferrisia virgata cockerell (hemiptera: pseudococcidae) 
Fruit fly: bactrocera spp, b. Zonata saunders (diptera: tephritidae) 
Scales: ceroplastes floridensis comstock (hemiptera: coccidae) 
Fruit boring caterpillar: heterographis bengalella ragonot (syn: anonaepestis bengalella) (lepidoptera: pyralidae) 

Diseases

Fruit rot &amp; anthracnose: colletotrichum gloeosporioides (penz.) penz. And sacc. (perfect stage glomerella cingulata (stoneman) spauld. &amp; h. Schrenk 
 alternaria leaf spot: alternaria spp. 
 cylindrocladium leaf spot: cylindrocladium colhounii and cylindrocladium scoparium 
 diplodia rot: botryodiplodia theobromae patouillard 
Black canker: phomopsis annonacearum (bond) mont. 

Nematodes

Spiral nematode: helicotylenchus spp. 
Stint nematode: tylenchorhynchus spp. 

Weeds

Grasses

Bermuda grass: cynodon dactylon (l.) pers. Poaceae 
Annual brachiaria: brachiaria deflexa (schumach.) robyns poaceae 
Viper grass: dinebra retroflexa (vahl.) panzer. Poaceae 
Dropseed: sporobolus diandrus (retz.) p. Beauv., poaceae 

Broadleaf

Horse purslane: trianthema portulacastrum l. Aizoaceae 
Black nightshade: solanum nigrum l. Solanaceae 
False amaranth: digera arvensis forssk. Amaranthaceae 
Puncture vine: tribulus terrestris l. Zygophyllaceae 
Common cocklebur: xanthium strumarium l. Asteraceae 
Asthma herb/spurge: euphorbia hirta/geniculate l. Euphorbiaceae 
Carrot grass: parthenium hysterophorus l. Asteraceae 
Stone breaker: phyllanthus niruri l. Euphorbiaceae 
Sensitive plant: mimosa pudica l. Fabaceae 
Broadleaf woodsorrel: oxalis latifolia kunth oxalidaceae 
Common purslane: portulaca oleracea portulacaceae 

Sedges

Purple nut sedge: cyperus rotundus l. Cypraceae 

Rodents

Soft furred field rat: millardia meltada gray 
Indian mole rats/smaller: bandicoota bengalensis gray 
Common house rat: rattus rattus linn 
Bats

Ipm for custard apple

To know the ipm practices for custard apple, 

Source: , 

