Fennel pests

Pests of national significance

Insect pests

Aphid: hyadaphis coriandri das. (hemiptera: aphididae)
Thrips: thrips flavus schrank (thysanoptera: thripidae)
Leaf eating caterpillar/gram pod borer: helicoverpa armigera hübner (lepidoptera: noctuidae)
Cutworm: agrotis ipsilon hufnagel, &amp; agrotis segetum denis &amp; schiff ermüller (lepidoptera: noctuidae)
Cigarette beetle: lasioderma serricorne fabricius (coleoptera: anobiidae)
Drug store beetle: stegobium paniceum linnaeus (coleoptera: anobiidae)

Diseases

Leaf blight: ramularia foeniculi sibilia
Leaf spot: cercosporidium punctum (delacr.) deighton
Damping off: pythium aphanidermatum (edson) fitzp. (seedling)
Wilt: fusarium equiseti (corda) sacc.
Powdery mildew: erysiphe polygoni dc/ e. Heraclei
Collar rot: sclerotinia sclerotiorum (lib.) de bary
Root rot: rhizoctonia solani j.g. Kuhn

Nematode

Root-knot nematode: meloidogyne spp.

Weeds

Broadleaf

Lamb’s quarter: chenopodium album l. (chenopodiaceae)
Scarlet pimpernel: anagallis arvensis l. (primulaceae)
Yellow sweet clover: melilotus indica (l.) all. (fabaceae)
Fine leaf fumitory: fumaria parvifl ora lam. (fumariaceae)
Corn spurry: spergula arvensis l. (caryophylliaceae)
Wild onion: asphodelus tenuifolius cav. (xanthorrhoeaceae)

Grasses

Blue grass: poa annua l. (poaceae)
Canary grass: phalaris minor retz. (poaceae)

Sedges

Purple nut sedge: cyperus rotundus l. (cyperaceae)
Yellow sedge: cyperus campestris schrad. Ex nees (cyperaceae)

Ipm for fennel

To know the ipm practices for fennel, 

Source: and 

