Pea pests

Pests of national significance

Insect and mite pests

Pea pod borer:

Etiella zinckenella treitschke (lepidoptera: pyralidae) 
Helicoverpa armigera hübner (lepidoptera: noctuidae) 

Stem fly: ophiomyia phaseoli tyron.(diptera: agromyzidae)
Pea weevil: bruchus pisorum linnaeus (coleoptera: bruchidae)

Diseases

Powdery mildew: erysiphe pisi dc. Syn. E. Polygoni dc. 
Rust: uromyces fabae (pers.) schrot. &amp; uromyces fabae db. F. Sp. Pisisativae hiratsuka 

Nematodes

Root-knot nematode: meloidogyne incognita (kofoid &amp; white) chit. &amp; m. Javanica (treub) chitwood 

Rodents

Smaller bandicoot: bandicota bengalensis gray.

Major weeds

Broad leaf weeds 

Lambs quarter: chenopodium album l. (chenopodiaceae)
Sweet clover: melilotus albal. (fabaceae)
Common vetch: vicia sativa l. (fabaceae)
Yellow vetchling: lathyrus aphacal. (fabaceae)
Scarlet pimpernel: anagallis arvensis l. (primulaceae)
Wild fenugreek: trigonella polycerata auct. Non linn. (fabaceae)
Fineleaf fumitory: lam. (fumariaceae)
Asthma herb: euphorbia hirta l. (euphorbiaceae)
Congress grass: parthenium hysterophorus l. (asteraceae)
Field bindweed: convolvulus arvensis l. (convolvulaceae)

Grasses 

Chinese love grass: eragrostis unioloides (retz.) nees. Ex steud (poaceae)
Canary grass: phalaris minor retz. (poaceae)
Goosegrass: eleusine indica (l.) gaertner. (poaceae)
Wild oat: avena fatua l. (poaceae)
Bluegrass: poa annua l. (poaceae) sedges 
Purple nut sedge: cyperus rotundus l. (cyperaceae)

Pest of regional significance

Insect pests 

Pea aphid: acyrthosiphon pisum harris. (hemiptera: aphididae) 
Leaf miner: chromatomyia horticola goureau. (diptera: agromyzidae) 

Diseases 

Downy mildew: peronospora viciae (berk.) gäum. Syn. And peronospora pisi sydow. (indo genetic plains) 
Ascochyta blight: ascochyta pisi lib., ascochyta pinodes jones, ascochyta pinodella jones (himalayan region, chhattisgarh) 
White rot: sclerotinia sclerotiorum (lib.) de bary (jammu &amp; kashmir, ) 
Root rot: fusarium solani (mart.) sacc., rhizoctonia solani kühn. (, bihar and ) 
Fusarium wilt: fusarium oxysporum f. Sp. Pisi. (uttar pradesh, uttarakhand, himachal pradesh, jammu &amp; kashmir) 

Nematodes: 

Reniform nematodes: rotylenchulus reniformis linford and oliveira 

Major weeds

Broad leaf weeds 

Slender amaranth: amaranthus viridis hook. F. (amaranthaceae) 
Giradol: chrozophora plicata (vahl) a. Juss. Ex spreng (euphorbiaceae) 
Corn spurry: spergula arvensis l. (caryophyllaceae) 

Grasses 

Egyptian crowfoot grass: dactyloctenium aegyptium (l.) willd (poaceae) 

Sedges 

Yellow nut sedge: cyperus esculentus l. (cyperaceae)

Ipm for pea

To know the ipm practices for pea, 

Source: ; 

