Peach pests 

Pests of national significance

Insect pest

Stem borer: aeolesthes sarta solsky (coleoptera: cerambycidae) 
Flat headed borers: chrysobothris mali eschscholtz (coleoptera: buprestide) &amp;capnodis tenebrionis linne (coleoptera: buprestidae)
Peach tree borer: synanthedon exitiosa say (lepidoptera: sesiidae) 
Defoliating beetle: protactia neglecta &amp; adoretus sp. (coleoptera: scarabaeidae) 
Hairy caterpillar: lymantria obfuscata walker (lepidoptera: lymantriidae) 
San jose-scale: quadraspidiotus perniciosus comstock (hemiptera: diaspididae)
Apricot brown scale: lecanium corni (bouché) (hemiptera: coccidae) 
Peach leaf curl aphid: brachycaudus helichrysi kaltenbach (hemiptera: aphididae)

Diseases

Frosty mildew: cercosporella persica (sacc.) sacc 
Peach leaf curl: taphrina deformans (berk.) tul 
Leaf spot: phyllosticta cerasicola speg. 
Powdery mildew: sphaerotheca pannosa (wallr.) lév, podosphaera leucotricha(ellis &amp;everh.) e.s. Salmon 
Coryneum blight/shot hole: wilsonomyces carpophilus (lév.) m.b. Ellis 
Silver leaf and canker: chondrostereum purpureum (pers.) pouzar 2.7 white root rot: dematophora necatrix berl. Exprill 
Whisker rot: rhizopus stolonifer ehrenb 
Peach rust: tranzschelia discolour (fuckel) tranz. 
Collar rot: phytophthora sp. &amp; pythium sp 
Bacterial canker and gummosis: pseudomonas syringae pv. Morsprunorum (wormald) yong 
Brown rot: sclerotina fructicola (g. Winter) rehm &amp; s. Fructigena (j.schröt.) norton

Pest of regional significance

Insect pests

Green peach aphid: myzus persicae sulzer (hemiptera: aphididae) 
Tent caterpillar: malacosoma indica walker (lepidoptera: lasiocampidae)
Leaf rollers: archips argyrospilus &amp; subsidiaria sp walker (lepidoptera: tortricidae) 
Peach twig borer/apricot fruit borer: anarsia lineatella zeller (lepidoptera: gelechiidae) 
Root borer: dorysthenes hugelli ridt (coleoptera: cerambycidae) 
Consperse sting bug: euschistis conpersus uhler (hemiptera: pentatomidae) 
Peach fruit fly: bactrocera zonata (saunders), b. Ciliates &amp; b. Dorsali hendel (diptera: tephritidae) 
Green capsid: lygus pabulinus franz and wagner (hemiptera: miridae) 
Blue beetle: haltica semipicens (coleoptera)
Blossom thrips: taeniothrips spp, frankliniella dampfi priesner (thysanoptera: thripidae) 
Rose chaffer beetle: macrodactyplus subspinosus fabricius (coleoptera: scarabaeidae) 
Oriental fruit moth: grapholitha molester busck (lepidoptera:tortricidae) 
Peach stem aphid/ brown peach aphid/peach black aphid: pterochlorus persicae cholodkovsky (hemiptera: aphididae) 
Chaffer beetle: adoretus spp (coleoptera: scarabaeidae) 
Plum lakeworm: cremastopsychae pendula de joannis 
Codling moth: cydia pomonella li (lepidoptera: tortricidae) 
Mealy plum aphid: hyalopterus pruni geoffroy (hemiptera: aphididae)

Weeds

Broad leaf weeds

Tropical spiderwort: commelina benghalensis l. Commelinaceae 
Creeping wood sorrel: oxalis corniculata l. Oxalidaceae 
Goat weed: ageratum conyzoides l. Asteraceae 
Sowthistles: sonchus spp. Asteraceae 
Congress grass: parthenium hysterophorus l. Asteraceae 
Pig weed: amaranthus viridis l (amaranthaceae) 
Lambs quarter: chenopodium album (chenopodiaceae)
Spurge: euphorbia hirta l (euphorbiaceae) 
Sorrel: rumex dentatus l (polygonaceae) 
Creeping thistle: cirsium arvense (l.) scop. (asteraceae)

Grassy weeds

Bermuda grass: cynodon dactylon (l.) pers. Poaceae
Cogon grass: imperata cylindrica (l.) raeusch.poaceae 
Blanket grass: axonopus compressus (sw.) beauv. Poaceae 
Large crabgrass: digitaria sanguinalis l. (scop.) poaceae 
Knot grass: paspalum distichum l. Poaceae 
Cannary grass: phalaris miner retz. Poaceae 
Crow foot grass: dactyloctenium aegyptium (l.) willd. Poaceae 

Sedges

Purple nut sedge: cyperus rotundus l. Cyperaceae 
Flat sedge: cyperus iria l. Cyperaceae

Ipm for peach
To know the ipm practices for peach, 
Source: ; 

