Sorghum pests

Pests of national significance

Insect pests

Shoot fly: atherigona soccata (rondani) (diptera: muscidae)
Stem borer: chilo partellus (swinhoe) (lepidoptera: pyralidae)
Midge: stenodiplosis sorghicola (coquillett) (diptera: cecidomyiidae)
White grub: holotrichia consanguinea (hope) (coleoptera:scarabaeidae)

Diseases

Grain mold: fusarium sp.,phomasp. (saccardo) curvularia sp. 
Charcoal rot: macrophomina phaseolina (tassi, goid)

Weeds

Broad leaf

Cock'scomb: celosia argentea l. (amaranthaceae)
Common purselane: portulaca oleraceal.( portulacaceae)
False amaranth: digera arvensis (forssk) (amaranthaceae)
Horsepurslane: trianthema portulacastrum l. (aizoaceae)
Pigweed: amaranthus viridis (hook. F.)(amaranthaceae)
Swinecress: coronopus didymus l. Sm. (brassicaceae)
Black nightshade: solanum nigrum l. (solanaceae)
Sessilisjoywood: alternanthera sessilis l dc (amaranthaceae)
Punarnava: boerhavia diffusa l. (nyctagnaceae)
Tropical spiderwort: commelina benghalensis l (commelinaceae)
Whitetop weed: parthenium hysterophorus l (asteraceae)
Bullhead: l (zygophyllaceae)
Coat button: tridax procumbensl(asteraceae)

Grasses

Rabbit/crow foot grass: dactyloctenium aegyptium (willd) (poaceae)
Goosegrass: eleusine indica l. (gaertner) (poaceae)
Barnyard grass: echinochloa crusgallil. (scop) (poaceae)
Crabgrass: digiteria sanguinalis l. (scop) (poaceae)
Burmuda grass: cynodon dactylon (poaceae)
Johnson grass: sorghum halepense l pers (poaceae)
Gamba grass: brachiaria ramose l (poaceae)
Finger grass: chloris barbata sw (poaceae)

Sedges

Purplenutsedge: cyperus rotundus l (cypraceae)
Flat sedge: cyperus iria l. (cypraceae)

Parasitic weeds

Witchweed: striga asiatica l. (kuntze) (orobanchaceae)

Nematode

Lesion nematode: pratylenchus spp. (tylenchida: pratylenchidae)
Cyst nematode: heterodorasorghii

Vertebrates

Rodent: springhare sp. (rodentia)
Parrot: psittacines sp. (psittaciformes)
Crow: corvus spp. (passeriformes: corvidae)

Pests of regional significance

Insect and mite pests

Armyworm: mythimna separate (walker) (lepidoptera: noctuidae) karnataka, maharashtra
Cutworms: agrotisipsilon (ochsenheimer) (lepidoptera: noctuidae)
Grasshopper: hieroglyphus sp (krauss) (orthoptera: acrididae) karnataka, rajasthan, , , , haryana, delhi
Pyrilla: pyrilla perpurilla (linnaeus) (hemiptera: lophopidae) maharashtra, madhya pradesh
Shoot bug: peregrinus maidis ( ashmead) (hemiptera: delphacidae) , madhya pradesh, karnataka, south india, tamil nadu, bihar, maharashtra
Earhead caterpillars: helicoverpa armigera (hubner) (lepidoptera: noctuidae) eublemma spp,(lepidoptera: noctuidae) crytoblabes spp. (lepidoptera: pyralidae) gujarat, andhra pradesh, tamil nadu, haryana, madhya pradesh, delhi, maharashtra
Earhead bug: calocoris angustatus (hemiptera: miridae) karnataka, andhra pradesh, tamil nadu, uttar pradesh
Sugar cane aphid: rhophalosiphum maidis koch (hemiptera: aphididae) andhra pradesh, delhi, gujarat, maharashtra
Spider mite: oligonychus indicus hirst (trombidiformes: tetranychidae) karnataka, punjab, maharashtra, tamil nadu

Diseases

Downy mildew: peronosclerospora sorghi (weston &amp; uppal, c.g. Shaw) rajasthan, tamil nadu, karnataka, andhra pradesh, maharashtra, haryana
Anthracnose: colletotrichum graminicola (d.j. Politis)
Loose smut: sporisorium cruenta (de bary)
Ergot: claviceps sorghi (b.g.p. Kulk)tamil nadu, karnataka, andhra pradesh, maharashtra
Grain smut: sporisorium sorghi (ehrenb ex. Link)
Red leaf spot : helminthosporium turcicum madhya pradesh, bihar, maharashtra
Rust : puccinia purpurea (cooke) karnataka, madhya pradesh, tamil nadu, uttar pradesh, maharashtra, andhra pradesh, bihar, central provinces

Ipm for sorghum

To know the ipm practices for sorghum, .

Source: and 

