Apricot pests

Pests of national significance in apricot

Insect pests

Flat headed borers: chrysobothris mali horn (coleoptera: buprestide) &amp;capnodis tenebrionis linne (coleoptera: buprestidae)
 hairy caterpillar:lymantria obfuscata walker (lepidoptera: lymantriidae)
Defoliating beetles: adoretos sp. &amp; brahmina sp
Leaf curl plum aphid: anuraphid helichyrysi kaltenbach (hemiptera: aphididae)
 brown apricot scale: lecanium corni (bouché) (hemiptera: coccidae)
 san jose-scale: quadraspidiotus perniciosus comstock (hemiptera: diaspididae)

Diseases

Brown rot blossom blight: monilinia laxa (aderh. &amp;ruhland) honey
Frosty mildew: cercosporella persica (sacc.) sacc
 powdery mildew: sphaerotheca pannosa (wallr.) lév
Coryneum blight/shot hole: stigmina corpophylla (lév.) m.b. Ellis 
 silver leaf and canker: chondrostereum purpureum (pers.) pouzar
 white root rot: dematophora necatrix berl. Exprill
Whisker rot: rhizopus stolonifer ehrenb
Collar rot: phytophthora spp &amp; pythium spp
 bacterial gummosis: pseudomonas spp

Pest of regional significance

Insect pests

Tent caterpillar: malacosoma indica walker (lepidoptera: lasiocampidae)
 leaf rollers: archips argyrospilus &amp; subsidiaria sp walker (lepidoptera: tortricidae)
Blue beetle: heltica semipicens (coleoptera:)
Ear wig: forficula auricularia linnaeus (dermaptera: forficulidae)
 codling moth: cydia pomonella linnaeus (lepidoptera: tortricidae)
Peach twig borer/apricot fruit borer: anarsia lineatella zeller (lepidoptera: gelechiidae)
Consperse sting bug: euschistis conpersus (hemiptera: pentatomidae)
Coconut rhinoceros beetle: oryctes rhinoceros linnaeus (coleoptera: scarabaeidae)
Blossom thrips: taeniothrips spp, frankliniella dampfi priesner (thysanoptera: thripidae)
Apricot chalcid: eurytoma samsona vivarsiliev (hymenoptera: chalci)
Mealy plum aphid: hyalopterous pruni geoffroy (homoptera: aphididae)

Weeds

Broad leaf weeds

Tropical spiderwort: commelina benghalensis l. Commelinaceae
Creeping wood sorrel: oxalis corniculata l. Oxalidaceae
 goat weed: ageratum conyzoides l. Asteraceae
Sowthistles: sonchus spp. Asteraceae
 congress grass parthenium hysterophorus l. Asteraceae
Musk rose: rosa moschata herrm. (rosaceae)
Brambles: rubus spp. (rosaceae)
Spurge: euphorbia hirta l (euphorbiaceae)
Common sorrel: rumex dentatus l (polygonaceae)
Lambs quarter: chenopodium album l (chenopodiaceae)

Grassy weeds

Bermuda grass: cynodon dactylon (l.) pers. Poaceae
Cogon grass: imperata cylindrica (l.) raeusch.poaceae
Blanket grass: axonopus compressus (sw.) beauv. Poaceae
Large crabgrass: digitaria sanguinalis l. (scop.) poaceae
Knot grass: paspalum conjugatum l. Poaceae

Sedges

 purple nut sedge: cyperus rotundus l. Cyperaceae
Flat sedge: cyperus iria l cyperaceae

Ipm for apricot

To know the ipm practices for apricot, 

Source: ; 

 

