Broccoli pests

Pests of national significance

Insect and mite pests

Diamondback moth: plutella xylostella l. (lepidoptera: plutellidae) 
Leaf webber: crocidolomia binotalis zeller (lepidoptera: pyralidae) 
Cabbage butterfly: pieris brassicae l. (lepidoptera: pieridae) 
Mustard sawfly: athalia lugens proxima klug (hymenoptera: tenthredinidae) 
Aphid: aphis spp. (hemiptera: aphididae) 
Painted bug: bagrada cruciferarum kirkaldy (hemiptera: pentatomidae) 
Cabbage head borer: hellula undalis fab. (lepidoptera: pyralidae) 
Termites: microtermes obesi holmgren (isoptera:termitidae) 
Cutworm: agrotis ipsilon hufnagel (lepidoptera: noctuidae) 
Leaf eating weevil: tanymecus circumdatus wiedemann (coleoptera: curculionidae) 
Leaf eating caterpillar/semilooper: trichoplusia ni hübner (lepidoptera: noctuidae) 
Leaf miner: chromatomyia horticola goureau (diptera: agromyzidae) 
Whitefly: bemesia tabaci gennadius (hemiptera: aleyrodidae) 
Red spider mites: tetranychus urticae koch (acari: tetranychidae) 

Diseases 

White blister: albugo candida (lev.) kunze 
Leaf blight: alternaria spp. 
Damping off: pythium aphanidermatum (eds.) fitz ; rhizoctonia solani kuhn 
Club root: plasmodiophora brassicae wor. 
Black rot : xanthomona scampestris pv. Campestris (dowson) dye, et al. 
Mosaic disease: cauliflower mosaic virus 
Root rot: pythium spp. 
Downy mildew: hyaloperonospora parasitica (pers.) constant. 

Nematodes

Root knot nematode: meloidogyne incognita kofoid &amp; white 
Reniform nematode: rotylenchulus reniformis linford and oliveira 

Weeds

Broadleaf 

Lamb’s quarter: chenopodium album l. (amaranthaceae) 
Scarlet pimpernel: anagallis arvensisl. (primulaceae) 
Yellow sweet clover: melilotus indica(l.) all. (fabaceae) 
Fine leaf fumitory: lam. (fumariaceae) 
Corn spurry: spergula arvensis l. (caryophyllaceae) 
Common purselane: portulaca oleracea l. (portulacaceae) 
Yellow pea: lathyrus aphaca l. (fabaceae) 

Grassy 

Blue grass: poa annua l. (poaceae) 
Canary grass: phalaris minor retz. (poaceae) 
Bermuda grass: cynadon dactylon l. (poaceae) 
Wild oat: avena ludoviciana thell (poaceae) 

Sedges 

Purple nutsedge: cyperus rotundus l. (cyperaceae) 

Rodents

Bandicoot rat: bandicota bengalensis gray 
Indian gerbil: tatera indica hardwicke 
Striped squirrel: funambulus spp.

Ipm for braccoli

To know the ipm practices for braccoli, .

Source: ; 

