 cherry pests

Pests of national significance

Insect pests

Stem borer: aeolesthes sarta solsky (coleoptera: cerambycidae)
Round headed borer: macrotoma crenata lameere (coleoptera: cerambycidae)
Indian gypsy moth/kashmir willow defoliator/hairy caterpillar: lymantria obfuscata walk. (lepidoptera: lymantriidae)

Diseases

Leaf spot/shot hole/brown rot: cercospora circumcissa sacc; c. Rubrotincta ellis &amp; everh
 bacterial gummosis: pseudomonas sp
Silver leaf canker: chondrostereum purpureum (pers.) pouzar
White root rot: dematophora necatrix berl. Ex prill
 whiskers rot: rhizopus stolonifer (ehrenb.: fr.) vuill.
Collar rot/root rot: phytophthora sp
Coryneum blight/shot hole: stigmina carpophila (lév.) m.b. Ellis
Powdery mildew: podosphaera clandestine (wallr.) lév.
Crown gall: agrobacterium tumefaciens smith townsend
Prunus necrotic ringspot: virus

Weeds

Broadleaf

Lambs quarter: chenopodium album l. (chenopodiaceae)
Tropical spiderwort: commelina benghalensis l. (commelinaceae)
Creeping wood sorrel: oxalis corniculata l. (oxalidaceae)
Goat weed:ageratum conyzoides l. (asteraceae)
Sow thistle: sonchus spp. (asteraceae)
 carrot grass: parthenium hysterophorus l. (asteraceae)
Mock strawberry: duchesnea indica (andr). Focke (rosaceae)
Musk rose/rosehip: rosa moschata herrm. (rosaceae)
Brambles: rubus spp. (rosaceae)
Common purslane: portulaca oleracea l. (portulacaceae)

Grasses

 bermuda grass: cynodon dactylon (l.) perse. (poaceae)
Canary grass: phalaris minor retz. (poaceae)
Cogon grass: imperata cylindrica (l.) raeusch. (poaceae)
Large crabgrass: digitaria sanguinalis l. (scop.) (poaceae)
Knot grass: paspalum distichum l. (poaceae)
Wire grass: eleusine indica l. (poaceae)
Coutch grass: elymus repens l. Gould. (poaceae)

Sedges

Purple nutsedge: cyperus rotundus l. (cyperaceae)
Annual sedge: cyperus compressus l. (cyperaceae)

Pest of regional significance

Insect pests

Leaf roller/tiger moth: panaxia principalis kollar (lepidoptera: noctuidae)
Mealy plum aphid: hyalopterus arundinis geoffroy (hemiptera: aphididae)
Case bearer caterpillar: coleophora nigricella stephens (lepidoptera: coleophoridae)
Pear psylla: psylla pyricola (foerster) (hemiptera: psyllidae)
Defoliating beetles: adoretus sp. &amp; brahmina sp. (coleoptera: scarabaeidae)
Root borer: dorysthenes hugelii redt. (coleoptera: scarabaeidae)
Green peach aphid: myzus persicae sulzer (hemiptera: aphididae)
Chaffer beetle: protaetia impavida jonson (coleoptera: scarabaeidae)
Blossom thrips: thrips flavus schrank (thysanoptera: thripidae)

Ipm for cherry

To know the ipm practices for cherry, 

Source: ; 

