Coconut pests 

Pests of national significance

Insect and mite pests

Rhinoceros beetle: oryctes rhinoceros guest (coleoptera: scarabaeidae)
Red palm weevil: rhynchophorus ferrugineus olivier (coleoptera: curculionidae)
Black headed caterpillar: opisina arenosella walker (lepidoptera: xylorictidae)
Eriophyid mite: aceria guerreronis keifer (acarina: eriophyidae)
Termite: odontotermes sp (isoptera: termitidae)

Diseases

Bud rot: phytophthora palmivora butler
Stem bleeding: thielaviopsis paradoxa de seynes
Leaf rot: exserohilum rostratum &amp; colletotrichum gleosporioides drechsler
Cadang cadang disease: coconut cadang-cadang viroid (cccvd)

Weeds

Broadleaf

Crofton weed: eupatorium odoratum l. (asteraceae)
Sensitive plant: mimosa pudica l. (fabaceae)
Siam weed: chromolaena odorata l. R.m. King &amp; h. Rob (asteraceae)
Carrot grass: parthenium hysterophorus l. (asteraceae)
Coatbuttons: tridax procumbens l. (fabaceae)
Pigweed: amaranthus viridis hook. F. (amaranthaceae)
Common purselane: portulaca oleracea l. (portualacaceae)
Field bindweed: convolvulus arvensis l. (convolvulaceae)

Grasses

Cogon grass: imperata cylindrica (l.) raeusch. (poaceae)
Goose grass: eleusine indica (l.) gaertner. (poaceae)
Burmuda grass: cynodon dactylon (poaceae)

Sedges

Purple nutsedge: cyperus rotundus l. (cyperaceae)
Flat sedge: cyperus iria l. (cyperaceae)

Nematodes

Burrowing nematode: radopholus similis

Rodents

Palm civet: vivera zibatha (carnivora: viverridae)
Black rat: rattus rattus linnaeus (rodentia: muridae)
Indian gerbil: tatera indica hardwicke (rodentia: muridae) (nursery/seedling)
The lesser bandicoot or indian mole-rat: bandicota bengalensis hardwicke (rodentia: muridae)

Pests of regional significance

Insect pests

Cock chafer beetle: leucopholis coneophora burm (coleoptera: scarabaeidae)
Coreid bug: paradasynus rostratus (hemiptera: heteroptera)

Diseases

Tanjavur wilt: ganoderma lucidum lingzhi or reishi
Root wilt: phytoplasma sp
Papery leaf blight: pestalotia palmarum cooke

Ipm for coconut

To know the ipm practices for coconut, 

Source: and 

