Fig pests

Pests of national significance

Insect pests

Stem borer: batocera rufomaculata (de geer) (coleoptera: cerambicidae) 
Fruit fly: bactrocera spp. (diptera: tephritidae) 
Fig midge: anjeerodiplosis peshawarensis mani (diptera: cecidomyiidae) 
Mealybug: drosicha stibbingi green (hemiptera: coccidae) 
Coccid: pseudococcus lilacinus cokerell. (hemiptea: pseudococcidae)

Diseases

 rust: cerotelium fici(castagne) arthurct pests 
Anthracnose: sphaceloma fici caricae wani &amp; thirum. 
Leaf spot: cylindrocladium scoparium morgan 8 
Alternaria rot (surface mold): alternaria spp., cladosporium herbarum (pers.) link, ulocladium altum (preuss) sacc. 
Aspergillus rot: aspergillus spp 
Smut: aspergillus spp.
Fig mosaic: fig mosaic virus (fmv) 
Leaf blight: pellicularia kolerga cooke
Fig rust: physopella fici (castagne) arthur

Weeds

Broadleaf

Carrot grass: parthenium hysterophorus l. (asteraceae)
Tick weed: cleome viscosa l. (capparaceae) 
Horse purslane: trainthema portulacastrum l. (aizoaceae)
Devilâ€™s horsewhip: achyranthes aspera l. (amaranthaceae) 
Pigweed: amaranthus viridis hook. F. (amaranthaceae) 
Creeping thistle: cirisium arvense (l.)scop (asteraceae) 
Spurge: euphorbia hirta l. (euphorbiaceae) 
Spiny amaranth: amaranthus spinosus l. (amaranthaceae)

Grasses

Rabbit/crow foot grass: dactyloctenium aegyptium (l.) willd (poaceae) 
Crab grass: digiteria sanguinalis (l.) scop. (poaceae) 
Yellow foxtail: setaria glauca (l.) p. Beauv. (poaceae) 
Bermuda grass: cynodon dactylon (l.) pers. (poaceae)
Southern crab grass : digitaria ciliaris (retz.) koeler (poaceae)

Sedges

Purple nut sedge : cyperus rotundus l. (cyperaceae) 
Umbrella sedge : cyperus difformis l. (cyperaceae)

Nematodes

Root-knot nematode: meliodogyne sp (tylenchida: meloidogynidae) 
Sheath nematode: hemicycliophora arenaria raski (tylenchida: criconematidae) 
Spiral nematodes: helicotylenchus multicinctus (cobb) golden (tylenchida: hoplolaimidae) 
Lance nematodes: hoplolaimus sp. (tylenchida: hoplolaimidae) 
Dagger nematode: xiphinema sp. (dorylaimida: longidoridae)

Rodents

Soft furred orchard rat: rattus meltada gray (rodentia: muridae) 
Indian mole rats/smaller bandicoot: bandicota bengalensis gray (rodentia: muridae) 
Common house rat: rattus rattus l. (rodentia: muridae)

Pest of regional significance

Insect pests

Leaf roller: phycodes minor moore (lepidoptera: brachodidae) 
Fig moth: ephestia cautella walker (lepidoptera: pyralidae) 
Thrips: scirtothrips tabaci (thysanoptera: thripidae) 
Fig jassids: velucariae sp 
Scale: parlatoria oleae colvee (hemiptera: diaspididae) 
Borer: aclees sp. (coleoptera: curculionidae)

Disease

Mosaic disease (viral disease)

Ipm for fig

To know the ipm practices for fig, 

Source: ; 

