Garlic pests 

Pests of national significance

Insect and mite pests

Onion thrips: thrips tabaci lindeman (thysanoptera: thripidae)
Onion maggot: delia antiqua meigen (diptera: anthomyiidae)
Bulb mite: rhizoglyphus robini claparédè (sarcoptiformes: acaridae)
Eriophyid mite: aceria tulipae (keifer) (prostigmata: eriophyidae)
Red spider mite: tetranychus cinnabarinus (boisduval) (trombidiformes: tetranychidae)

Diseases

Damping off: pythium spp., rhizoctonia solani ( kühn), fusarium oxysporum (schlecht), f. Oxysporum f. Sp. Cepae (schlecht. Emend. Snyder &amp; hansen); sclerotium rolfsii (sacc.) &amp; s. Cepivorum (berk ) and colletotrichum sp
Purple blotch: alternaria porri (ellis)
Stemphylium leaf blight: stemphylium cesicarium/ vesicarium [(wallr.) e.g. Simmons]
Colletotrichum blight/anthracnose/twister disease: colletotrichum gloeosporioides [(penz.) penz. And sacc]
Onion yellow dwarf: onion yellow dwarf virus
Iris yellow spot: iris yellow spot virus

Weeds

Major kharif broad leaf

Pigweed: amaranthus viridis hook. F. (amaranthaceae)
Swine cress: coronopus didymus (l.) sm. (brassicaceae)
Black nightshade: solanum nigrum l. (solanaceae)
Common purselane: portulaca oleracea l. (portulacaceae)
False amaranth: digera arvensis forssk. (amaranthaceae)

Grassy

Rabbit/crow foot grass: dactyloctenium aegyptium (l.) beauv. (poaceae)
Crab grass: digiteria sanguinalis (l.) willd. (poaceae)
Barnyard grass: echinochloa crusgalli (l.) scop. (poaceae)

Sedge

Purple nutsedge: cyperus rotundus l. (cyperaceae)
Flat sedge: cyperus iria l. (cyperaceae)
Major rabi

Broadleaf

Lamb’s quarter: chenopodium album l. (chenopodiaceae)
Scarlet pimpernel: anagallis arvensis l. (primulaceae)
Sweet clover: melilotus indica (l.) all. (fabaceae)
Fine leaf fumitory: fumaria parvifl ora lam. (fumariaceae)
Corn spurry: spergula arvensis l. (caryophyllaceae)
Carrot grass: parthenium hysterophorus l. (asteraceae)

Grassy

Blue grass: poa annua l. (poaceae)
Canary grass: phalaris minor retz. (poaceae)
Chinese love grass: eragrostis unioloides (retz.) nees. Ex steud. (poaceae)
Goose grass: eleusine indica (l.) gaertner (poaceae)

Sedge

Purple nut sedge: cyperus rotundus l. (cyperaceae)

Pests of regional significance

Insect pests

Gram pod borer: helicoverpa armigera (hübner) (lepidoptera: noctuidae)
Tobacco caterpillar: spodoptera litura (fabricius) (lepidoptera: noctuidae)
Cutworm: agrotis ipsilon (hufnagel) (lepidoptera: noctuidae)

Diseases

Downy mildew: perenospora destructor (berkeley) caspary
Fusarium basal rot/ basal rot: fusarium oxysporum f. Sp. Cepae schlecht ()
White rot: sclerotium cepivorum berk. ()
Pink root rot: phoma (pyrenochaeta) terrestris (hansen) gorenz, walker &amp; larson, fusarium solani (mart.) sacc.
Black mold: aspergillus niger van tiegham
Green mold: aspergillus fumigatus fresenius, a. Alliaceus thom &amp; church
Bacterial brown rot/ slippery skin: pseudomonas aeruginosa (schroter) migula, pseudomonas allicola starr and burk
Soft rot: erwinia carotovora pv. Carotovora jones

Ipm for garlic

To know the ipm practices for garlic, 

Source: and 

