Jackfruit pests

Pests of national significance

Insect pests

Shoot and fruit borer: glyphodes caesalis (walker), (lepidoptera: pyralidae)
Spittle bugs: cosmocarta relata distant (hemiptera: cercopidae) 
Mealybug: drosicha mangiferae stebbins (hemiptera: margarodidae) 
Bud weevil: ochyromera artocarpi marshall (coleoptera: curculionidae)
Bark eating caterpillar: indarbela tetraonis (moore) (lepidoptera: cossidae) 
Aphid: greenidea artocarpi (westwood) (hemiptera: aphididae) 
Leaf webber: glyphodes bivitralis guene√© (lepidoptera: crambidae)

Diseases:

Soft rot or fruit rot: rhizopus artocarpi racib. 
Dieback: botryodiplodia theobromae pat. 
Leaf spot: phyllosticta artocarpina speg. 
Pink disease: botryobasidium salmonicolaor (berk. &amp; broome) &amp; corticium salmonicolor (berk. &amp; broome)

Weeds:

Broadleaf

Asthma herb: euphorbia hirta l. (euphorbiaceae) 
Cock's comb: celosia argentea l. (amaranthaceae) 
Pigweed: amaranthus viridis hook. F. (amaranthaceae) 
Goat weed: ageratum conyzoides l. (asteraceae) 
Carrot grass: parthenium hysterophorus l. (asteraceae) 
Coat buttons: tridax procumbens l. (fabaceae) 
Tick weed: cleome viscosa l. (cappariaceae) 
Horse purslane: trainthema portulacastrum l. (aizoaceae) 
Creeping thistle: cirisium arvense (l.) scop (asteraceae) 

Grasses

Bermuda grass: cynodon dactylon (l.) pers. (poaceae) 
Large crabgrass: digitaria sanguinalis l.(scop.) (poaceae)
Yellow foxtail: setaria glauca (l.) p. Beauv. (poaceae) 
Goose grass: eleusine indica (l.) gaertner. (poaceae) 
Rabbit/crow foot grass: dactyloctenium aegyptium (l.) willd (poaceae) 

Buffalow grass: paspalum conjugatum berggius (poaceae) 

Sedges

Purple nutsedge: cyperus rotundus l. (cypraceae) 
Umbrella sedge: cyperus difformis l. (cyperaceae)

Pests of regional significance

Insect pests

Stem borer: batocera rufomaculata (degeer) (coleoptera: cerambycidae) 
Pink waxy scale: ceroplastes rubens maskell (hemiptera: coccidae) 
Thrips: pseudodendrothrips dwivarna ramakrishna &amp; margabandhu (thysanoptera: thripidae) 
Aphid: toxoptera aurantii (boyer.) (hemiptera: aphididae) 
Castor capsule borer: dichocrocis punctiferalis (gunee) (lepidoptera: crambidae) 
Fruit fly: bactrocera umbrosa fabricius (diptera: tephritidae)

Disease

Rust: uredo artocarpi berk. &amp; broome 
Anthracnose: colletotrichum gloeosporioides (penz.) penz. &amp;. Sacc

Ipm for jackfruit

To know the ipm practices for jackfruit, 

Source: ; 

