Lentil pests

Pests of national significance

Insect pests

Cow pea aphid: aphis craccivora koch (hemiptera: aphididae) 
Pea aphid: acyrthosiphon pisum haris (hemiptera: aphididae) 
Leaf weevil: sitona spp. (coleoptera: curculionidae) 
Lygus bugs: lygus spp. (hemiptera: miridae) 
Cut worm: agrotis ipsilon (hufnagel) (lepidoptera: noctuidae) 
Thrips: thrips tabaci lindeman (thysanoptea: thripidae) 
Pod borers: helicoverpa armigera (hubner) (lepidoptera: noctuidae) 
Spiny pod borer: etiella zinckenella (treit.) (lepidoptera: pyralidae) 
Pulse beetles: bruchus spp., callosobruchus spp. (coleoptera: bruchidae)

Diseases

Root rot and seedling disease: pythium ultimum trow, rhizoctonia solani kühn 
Fusarium wilt : fusarium oxysporum (schlecht)snyder &amp; hansen (hypocreales: nectriaceae) 
Lentis rust: uromyces fabae (pers.) schröt. 
Ascochyta blight: ascochyta lentis jellis &amp; punith 
Anthracnose: colletotrichum truncatum (schwein.) andrus &amp; moore 
Powdery mildew: erysiphe pisi dc.,
Sclerotinia rot/collar rot: sclerotinia rolfsii sacc. 
Pea enation mosaic virus
Bean yellow mosaic virus 
Pea seed borne mosaic virus (psbmv).

Weeds

Broadleaf weeds

Field bind weed: convolvulus arvensis l. (convolvulaceae) 
Lambs quarter: chenopodium album l. (chenopodiaceae) 
Sweet clover: melilotus indica (l.) all. (fabaceae) 
Scarlet pimpernel: anagalis arvensis (primulaceae) 
Onion weed: asphodelus tenuifolius cav. (liliaceae) 
Carrot grass: parthenium hysterophorus l. (asteraceae) 
Benghal dayflower: commelina benghalensis l. (commelinaceae)

Grasses

Wild oat: avena ludoviciana (l.) nees. (poaceae) 
Canary grass: phalaris minor retz. (poaceae) sedges 
Purple nutsedge: cyperus rotundus l. (cyperaceae) 
Yellow nutsedge: cyperus esculentus l. (cyperaceae) parasitic weed 
Dodder: cuscuta spp.(convolvulaceae) 
Broomrape: orobanche spp. (orobanchaceae)

Nematode 

Cyst nematode: heterodera ciceri (tylenchida: heteroderidae)

Ipm for lentil

To know the ipm practices for lentil, 

Source: ; 

