Passion fruit pests

Pests of national significance

Insect and mite pests

 aphids: myzus persicae (sulzer), aphis gossypii (glover) and macrosiphum solanifolii thomas (hemiptera: aphidae)
 mealy bugs: planococcus citri risso, planococcus pacificus cox (homoptera: pseudococcidae)
 fruit flies: bactrocera latifrons, b. Dorsalis, b. Cucurbitae (diptera: tephritidae)
 scales: coccus hesperidum linnaeus (hemiptera: coccidae), aonidiella aurantii (maskell) (hemiptera: diaspididae)
 mites: brevipalpus phoenicis (geijskes) (trombidiformes :tenuipalpidae), tetranychus mexicanus (mcgregor) and t. Desertorum banks (acari: tetranychidae)

Diseases

 brown spot: alternaria passiflorae j.h. Simmonds, proc. Roy. Soc. And a. Alternata
 septoria blotch (spot) : septoria fructigena berk. M.a. Curtis, grevillea, s. Passifloricola punith and s. Passiflorae louw
 root and crown rot: pythium splendens hans braun, p. Aphanidermatum (edson) fitzp, phytophthora cinnamomi rands and p. Nicotianae breda de haan
 fusarium wilt: fusarium oxysporum schlecht. Emend. Snyder hansen
 woodiness of passion fruit: passion fruit woodiness virus (pwv) and cucumber woody virus (cwv)
 scab or cladosporium rot: cladosporium cladosporioides (fresen.) g.a. De vries and c. Herbarum (pers.) link 
 anthracnose : colletotrichum gloeosporioides (penz.) penz. . Sacc orchard

Weeds

Broadleaf

 lambâ€™s quarter : chenopodium album l. (chenopodiaceae)
Creeping wood sorrel: oxalis corniculata l. (oxalidaceae)
Wild sage: lantana camara l. (verbenaceae)
Wire weed: sida acuta burm.f. (malvaceae)
Siam weed: chromolaena odorata (l) king h.e. Robins (asteraceae)
Buckthorm: rhamnus nepalensis (wall.) lawson (rhamnaceae)
Goat weed: ageratum conyzoides l. (asteraceae)
Stinkbells: circaester agrestis maxim. (circaestraceae)
Crofton weed: ageratina adenophora (spring.) (asteraceae)
Carrot grass: parthenium hysterophorus l. (asteraceae)
Common purslane: portulaca oleracea l. (portulacaceae)
Pink knotweed: persicaria napalensis (meisn.) miyabe (polygonaceae)

Grassy 

 bermuda grass: cynodon dactylon l.pers. (poaceae)
 blue grass: poa annua l. (poaceae)
 itch grass: rottboellia exaltata l.f. (poaceae)
 johnson grass: sorghum halepense (l) pers. (poaceae)

Sedges

Purple nut sedge : cyperus rotundus l. (cyperaceae)

Rodents

 soft furred orchard rat: rattus meltada
 indian mole rat: bandicota bengalensis
 common house rat: rattus rattus

Ipm for passion fruit

To know the ipm practices for passion fruit, 

Source: ; 

