Persimmon pests

Pests of national significance

 insect and mite pests

Mealybug: pseudococcus longispinus (targioni-tozetti) (hemiptera: pseudococcidae)
 scales: parthenolecanium corni bouch√© (hemiptera: coccidae) hemiberlesia rapax comstock (hemiptera: diaspididae)
 fruit fly: bactrocera dorsalis hendel (diptera: tephritidae)
 twig girdlers &amp; borers: chrysobothris mali horn (coleoptera: buprestidae)
 persimmon psylla: trioza diospyri (ashmead) (hemiptera: psyllidae)
 leaf rollers: hypocala rostrata fabricius (lepidoptera: erebidae)
 mites: orthotydeus sp. (trombidiformes: tydeidae)
Thrips

Diseases

 crown gall: agrobacterium radiobacter beijerinck and van delden
 root rot: dematophora necatrix (hartig)
 cercospora leaf spot: cercospora kaki ellis everhart
 circular leaf spot: mycospharella nawae hiura ikata
 bitter rot or anthracnose: gloeosporium kaki hori
 leaf spots: alternaria alternata (fr.) kessl.
 post-harvest fruit rot: penicillium cyclopium westling
 anthracnose: colletotrichum gloeosporioides (penz.) penz. Sacc.

Weeds

Broadleaf

Lambs quarter: chenopodium spp. L. (chenopodiaceae)
Tropical spiderwort: commelina benghalensis l. (commelinaceae)
Creeping wood sorrel: oxalis corniculata l. (oxalidaceae)
Goat weed: ageratum conyzoides l. (asteraceae)
Sow thistles: sonchus spp. (asteraceae)
Congress grass: parthenium hysterophorus l. (asteraceae)

Grasses

Bermuda grass: cynodon dactylon l. (poaceae)
Wild oat: avena ludoviciana (l.) nees. (poaceae)
Canary grass: phalaris minor retz. (poaceae)
 cogon grass: imperata cylindrica l. Raeusch. (poaceae)
 large crabgrass: digitaria sanguinalis l. (scop.) (poaceae)
 knot grass: paspalum distichum l. (poaceae)

Sedges

 purple nutsedge: cyperus rotundus l. (cyperaceae)
 yellow nutsedge: cyperus esculentus l. (cyperaceae)

Nematode

 root-knot nematode: meloidogyne spp (tylenchida: meloidogynidae)

Rodents

Indian mole rat/smaller bandicoot: bandicota bengalensis gray (rodentia:

Muridae)

 soft furred field rat: milaridia meltada gray (rodentia: muridae)
 field mouse: mus booduga gray (rodentia: muridae)

Ipm for persimmon

To know the ipm practices for persimmon, 

Source:

