Raspberry pests

Pests of national significance

Insect and mite pests

 hadda beetle: epilachna vigintioctopunctata (fabricius) (coleoptera: coccinellidae)
 fruit borer: helicoverpa armigera hubner (lepidoptera: noctuidae)
 cut worm: agrotis spp. (lepidoptera: noctuidae)
 aphid: aphis spp. (homoptera: aphididae)
 two spotted spider mite: tetranychus urticae koch (arachnida: acari: tetranychidae)
 thrips: frankliniella spp. (thysanoptera: thripidae)

Diseases

 bacterial blight: pseudomonas syringae van hal
 powdery mildew: sphaerotheca macularis braun and takam
 fruit rot disease: alternaria alternata keissi and cladosporium cladosporiodes bensch
 cane botrytis (gray mold wilt): botrytis cinerea de bary
 cane blight: leptosphaeria coniothyrium sacc.
 spur blight: didymella applanta niessl
 fire blight: erwinia amylovora burrill and winslow
 anthracnose: elsinoe veneta jenkins
 botrytis fruit rot: botrytis cinerea pers.
 root rots: pythium spp, phytophthora spp, rhizoctonia spp and fusarium spp
 bacterial blight: pseudomonas syringae van hall
 crown gall and cane gall: agrobacterium tumifaciens smith townsend, agrobacterium rubi young et al.
 verticillium wilt: verticillium dahlia kleb, verticillium albo-atrum reinke &amp; berthold
 leaf spot: sphaerulina rubi demaree &amp; wilcox
 tomato ringspot virus
 mosaic virus

Weeds

Broad leaf weeds

 pig weed: amaranthus viridis hook. F. (amaranthaceae)
Spiny amaranth: amaranthus spinosus l. (amaranthaceae)
 little mallow (cheese weed):malva parviflora l (malvaceae)
 sowthistle: sonchus oleraceus (asteracea)
 tropical spiderwort: commelina benghalensis l. (commelinaceae)
 horse purslane: trienthema portulacastrum l. (aizoaceae)
False amaranth: digera arvensis forrsk. (amaranthaceae)
 false daisy: eclipta prostrarta l. (asteraceae)
 toothed dock: rumex dentatus l. (polygonaceae)
 wood sorrel: oxalis corniculata l. (oxalidaceae)

Grassy weeds

 bermuda grass: cynodon dactylon (l.) pers. (poaceae)
 conch grass: agropyron repens (poaceae)
 large crabgrass: digitaria sanguinalis l.(scop.) (poaceae)
 wire grass: eleusine indica l. (poaceae)

Sedges

 purple nutsedge: cyperus rotundus l. (cyperaceae)
 annual sedge: cyperus compressus l. (cyperaceae)

Rodents

 soft furred field rat: rattus meltada
 indian mole rat/ smaller bandicot: bandicota bengalensis
 common house rat: rattus rattus

Ipm for raspberry

To know the ipm practices for raspberry, 

Source: ; 

