Sunflower pests

Pests of national significance in sunflower

Insect pests

Tobacco caterpillar: spodoptera litura fabricius (lepidoptera: noctuidae)
Head borer: helicoverpa armigera h√ºbner (lepidoptera: noctuidae)
Jassids: amrasca biguttula ishida (homoptera: cicadellidae)
Thrips: scirtothrips dorsalis hood (thripidae: thysanoptera)
Green semilooper: thysanoplusia orichalcea fabricius (lepidoptera: noctuidae)
Cabbage semilooper: trichoplusia ni (hubner) (lepidoptera: noctuidae)
Bihar hairy caterpillar: spilosoma obliqua walker (lepidoptera: arctiidae)
Cutworm: agrotis ipsilon rott (lepidoptera: noctuidae)
Termite: odontotermes obesus (rambur) &amp; microtermes obeli hol (isoptera: termitidae)

Diseases

Alternaria leaf spot: alternaria helianthi (hansf.) tubaki &amp; nishi
Sunflower necrosis disease: tobacco streak virus
Downy mildew: plasmopara halstedii farl. Berl. &amp; de toni
Rust: puccinia helianthi schwein
Sclerotium wilt: sclerotium rolfsii sacc
Charcoal rot: macrophomina phaseolina (tassi) goid
Sclerotinia wilt and rot: sclerotinia sclerotiorum (lib.) de bary

Pests of regional significance

Insect pests

Whitefly: bemisia tabaci gennadius (hemiptera: aleyrodidae)
Armyworm: spodoptera exigua (hubner) (lepidoptera: noctuidae)

Diseases

Head rot: rhizopus arrhizus fischer
Powdery mildew: erysiphe cichoracearum f.sp. Helianthi dc ex meret and sphaerotheca fuliginea (schlecht.ex fr) pollacci

Weeds

Grassy weeds

Rabbit/crow foot grass: dactyloctenium aegyptium willd ( poaceae)
Goose grass: eleusine indica l. Gaertner (poaceae)
Crabgrass: digiteria sanguinalis l.scop (poaceae)
Burmuda grass: cynodon dactylon (l) pers (poaceae)
Cannery grass: phalaris minor retz. (poaceae)
Barnyard grass: echinochloa colona (l.) link, e. Crusgalli (l.) honda (poaceae)
Viper grass: dinebra retroflexa (vahl) panz (poaceae)
Sweet signal grass: brachiaria eruciformis (sm.) griseb (poaceae)

Broad leaf

False amaranth: digera arvensis forssk (amaranthaceae)
Pigweed: amaranthus viridis hook. F. (amaranthaceae)
Swine cress: coronopus didymus l. Sm. (brassicaceae)
Black nightshade: solanum nigrum l. (solanaceae)
Common purselane: portulaca oleracea l. (portulacaceae)
Carrot grass: parthenium hysterophorus l. (asteraceae)
Tropical spiderwort: commelina benghalensis l. (commelinaceae)
Stonebreaker: phyllanthus niruri l. Phyllanthaceae
Silver cockscomb: celosia argentea l. Amaranthaceae
Devil's horsewhip: achyranthes aspera l. Amaranthaceae

Sedges

Purple nutsedge: cyperus rotundus l (cypraceae)
Rice flatsedge: cyperus iria l (cyperaceae)
Yellow nutsedge: cyperus esculentus l (cyperaceae)

Vertebrates

Birds: parakeets

Ipm for sunflower

To know the ipm practices for sunflower, 

Source: ; 

