Clove pests

Pests of national significance in clove

Insect pests

Stem borer: sahyadrassus malabaricus moore (lepidoptera, hepialidae) 
Scale insects: parasaissetia nigra nietner, green scale: lecanium psidii green, wax scale: ceroplastes floridensis comstock, pulvinaria psidii (maskell),masked scale: mycetaspis personata comstock, soft scale: kilifia accuminata signoret (hemiptera:coccidae) 
Mealy bugs: planococcus sp. And psuedococus sp.(hemiptera: pseudococcidae)

Diseases

Seedling wilt: cylindrocladium sp., fusarium sp., rhizoctonia sp. 
Leaf rot: cylindrocladium quinquiseptatum boedijin and reitsma 
Leaf spot and bud shedding: colletotrichum gloeosporioides(penz.) penz. &amp;. Sacc

Weeds

Broad leaf weeds

Pigweed: amaranthus viridis hook. F. Amaranthaceae 
Common purselane: portulaca oleracea l. Portualacaceae 
False amaranth: digeria arvensis forssk. Amaranthaceae 
Carrot grass: parthenium hysterophorusl. Asteraceae 
Goat weed: ageratum conyzoidesl. Asteraceae 
Little mallow (cheese weed): malva parviflora f. Malvaceae

Grassy weeds

Barnyard grass: echinochloacrusgalli(l.) beauv. Poaceae 
Bermuda grass: cynodondactylon (l.) pers. Poaceae

Sedges

Nutsedge: cyperus rotundus/cyperus iria/cyperus difformisl. Cyperaceae

Nematodes

Ring nematode: criconemoidesspp.(tylenchida: criconematidae) 
Reniform nematode: rotylenchulusreniformislinford and oliveira (tylenchida: hoplolaimidae) 
Common spiral nematode: helicotylenchusdihystera(cobb) sher(tylenchida: hoplolaimidae)

Ipm for clove

To know the ipm practices for clove, 

Source: and 

