Cumin pests 

Pests of national significance

Insect pests

Aphid: myzus persicae sulzer, acyrthosiphon pisum harris and, aphis gossypii, a. Craccivora koch (hemiptera: aphididae)
Thrips: thrips tabaci lindeman (thysanoptera: thripidae)

Nematode

Root-knot nematode: meloidogyne spp.

Diseases

Wilt: fusarium oxysporum f. Sp. Cumini foc
Blight: alternaria burnsii uppal, patel &amp; kamat, a. Cucumerina ellis &amp; everh
Powdery mildew: erysiphe polygoni (va≈àha) weltzien
Damping off : pythium aphanidermatum (edson) fitzp.

Weeds

Broadleaf

Zeeri: plantago pumilla l. (plantaginaceae)
Lambs quarters: chenopodium album l. (chenopodiaceae)
Yellow sweet clover: melilotus indica medik. (fabaceae)
Wild onion: asphodelus tenuifolius cav (liliaceae)
Scarlet: anagallis arvensis l. (primulaceae)
Corn spurry: spergula arvensis l. (caryophylliaceae)
Fine leaf fumitory: fumaria parvifl ora lam (fumariaceae)
False daisy: (l.) hassk. (asteraceae)
Water primrose: ludwigia sp. (onagraceae)
Toothed dock: rumex sp. (polygonaceae)

Grasses

Canary grass: phalaris minor retz. (poaceae)
Goose grass: poa nnua l. (poaceae)
Rabbits foot grass: polypogon monspeliensis (l.) desf. (poaceae)
Burmuda grass: cynodon dactylon (l.) pers. (poaceae)

Sedges

Purple nut sedge: cyperus rotundus l. (cyperaceae)
Variable fl atsedge: cyperus diff ormis l. (cyperaceae)

Pests of regional significance

Insect pests

Tobacco caterpillar: spodoptera litura fabricius (lepidoptera: noctuidae)
Cutworm: agrotis ipsilon hufnagel (lepidoptera: noctuidae)
Jassid: eurymela fenestrata peletier &amp; serville (hemiptera: cicadellidae)
Cigarette beetle: lasioderma serricorne fabricius (coleoptera: anobiidae)
Drug store beetle: stegobium paniceum linnaeus (coleoptera: anobiidae)

Ipm for cummin

To know the ipm practices for cumin, 

Source: and 

