Oilpalm pests

Pests of national significance

Insect pests

Spindle bug: carvalhoia arecae (miller) (hemiptera: miridae)
Root grub: leucopholis burmeisteri (brenske) (coleoptera:melolonthidae)
Rhinocerous beetle: oryctes rhinoceros (linneaus) (coleoptera: scarabaeidae) 
Red palm weevil: rhynchophorus ferrugineus (olivier) (coleoptera: curculionidae) 
Case worm: pteroma pendula (de joannis) (lepidoptera: psychidae)
Acaria sp. 

Diseases

Stem wet root/ stem bleeding: theilaviopsis paradoxa (de seynes)
Bud rot disease: phytophthora palmivora (butler) 
Basal stem rot: ganoderma lucidum (karst) 
Bunch rot: marasmius palmivorus (sharples) 
Anthracnose: botryodiplodia palmarum (cooker) 
Leaf spot: pestalotiopsis spp 
Bacterial bud rot/spear rot: erwinia spp

Weeds

Broad leaf weeds

Crofton weed: eupatorium odoratum l. (asteraceae) 
Sensitive plant: mimosa pudica l. (fabaceae) 
Siam weed: chromolaena odorata (l) r.m. King &amp; h. Rob (asteraceae)
Carrot grass: parthenium hysterophorus l. (asteraceae)
Coat buttons: tridax procumbens l. (asteraceae) 
Horse purslane: trianthema portulacastrum l. (aizoaceae) 
Pig weed: amaranthus viridis hook. F. (amaranthaceae) 
Common purselane: portulaca oleracea l. (portualacaceae) 
Plantation bindweed: convolvulus arvensis l. (convolvulaceae) 
Painted spurge: euphorbia geniculata (ortega) klotzsch &amp; garcke (euphorbiaceae) 
False mallow: malvastrum coromandelianum (l.) garcke (malvaceae)

Grassy weeds

Cogon grass: imperata cylindrical (l.) raeusch. (poaceae) 
Goosegrass: eleusine indica (l.) gaertner. (poaceae) 
Burmuda grass:cynodon dactylon (poaceae) 
Rabbit/crow foot grass: dactyloctenium aegyptium (l.) willd (poaceae) sedges 
Purple nutsedge: cyperus rotundus l. (cyperaceae) 
Flat sedge: cyperus iria l. (cyperaceae)

Rodents

Lesser bandicoot: bandicota bengalensis 
Soft furred plantation rat: millardia meltada 
Common house rat: rattus rattus 

Vertebrate pest

Common mynah: acidotheres tristis 
Forest crow 

Pest of regional significance

Insect and mite pests

Scale: aspidiotus destructor (signoret) (hemiptera: diaspididae) 
Mealy bug: dysmicoccus brevipes (cockerell) (homoptera: pseudococcidae) 
Termites: odontotermes obesus (rambur) (isoptera: termiitidae)
Nettle caterpillar: thosea andamanica (holloway) (lepidoptera: limacodidae) 
Mite: tetranychus piercei (mcgergor) ((acarida: tetranychidae)

Ipm for oilpalm

To know the ipm practices for oilpalm, 

Source: , 

