Potato pests 

Pests of national significance

Insect pests

Aphids: myzus persicae sulzerand, aphis gossypii glover (hemiptera: aphididae)
Potato tuber moth: phthorimaea operculella zeller (lepidoptera: gelechiidae)
Jassids/ leaf hoppers: amrasca devastans dist. And empoasca fabae harris (hemiptera: cicadellidae)
Whitefly: bemisia tabaci gennadius (hemiptera: aleyrodidae)

Nematode

Root-knot nematode: meloidogyne sp.

Diseases

Late blight: phytophthora infestans (mont.) de bary
Black scurf: rhizoctonia solani j.g. Kühn
Leaf spot complex: alternaria sp, phoma sp.
Septoria leaf spot: septoria lycopersici var. Malagutii ciccarone &amp; boerema
Early blight: alterneria solani sorauer
Common scab: streptomyces scabies lambert and loria
Bacterial wilt: ralstonia solanacearum smith
Viral diseases : (potato virus x, s, y and potato leaf roll virus)

Weeds

Kharif
Broadleaf

Pigweed: amaranthus viridis hook. F. (amaranthaceae)
Swine cress: coronopus didymus (l.) sm. (brassicaceae)
Black nightshade: solanum nigrum l. (solanaceae)
Common purselane: portulaca oleracea l. (portulacaceae)
False amaranth: digera arvensis forsk. (amaranthaceae)

Grasses

Rabbit/ crow foot grass: dactyloctenium aegyptium (l.) beauv. (poaceae)
Crabgrass: digiteria sanguinalis (l.) willd. (poaceae)
Barnyard grass: echinochloa crusgalli (l.) beauv. (poaceae)

Sedges

Purple nutsedge: cyperus rotundus l. (cyperaceae)
Flat sedge: cyperus iria l. (cyperaceae)

Rabi
Broadleaf

Lamb’s quarter: chenopodium album l. (chenopodiaceae)
Scarlet pimpernel: anagallis arvensis l. (primulaceae)
Sweet clover: melilotus indica (l.) all. (fabaceae)
Fine leaf fumitory: lam. (fumariaceae)
Corn spurry: spergula arvensis l. (caryophyllaceae)
Goat weed: ageratum conyzoides l. (asteraceae)
Rough medic: medicago denticulata willd (fabaceae)
Broad leaf wood sorrel: oxalis latifolia kunth. (oxalidaceae)
Horse purslane: trianthema portulacastrum l. (aizoaceae)
Onion weed: asphodelus tenuifolius cav. (liliaceae)
Field bindweed: convolvulus arvensis l. (convolvulaceae)

Grasses

Blue grass: poa annua l. (poaceae)
Canary grass: phalaris minor retz. (poaceae)

Rodent and non-rodent vertebrate pests

Lesser bandicoot: bandicota bengalensis
Indian creased porcupine: hystrix indica
Wild boar: sus scrofa

Pests of regional significance

Insect and mite pests

Cut worm: agrotis segetum denis &amp; schiffer müller (lepidoptera: noctuidae) (tripura, gujarat, )
White grub: lachnosterna longipennis blanchard and l. Coracea (coleoptera: scarabaeidae)(himachal pradesh, )
Leafminer: liriomyza huidobrensi blanchard (diptera: agromyzidae)
Spider mites: polyphagotarsonemus latus banks (acarina: tarsonemidae) (maharashtra, karnataka, orissa)
Thrips: thrips sp (hemiptera: aphididae) (orissa)
Tobacco caterpillar: spodoptera litura fabricius (lepidoptera: noctuidae) (uttar pradesh, karnataka)
Leaf eating caterpillar/gram pod borer: helicoverpa armigera hübner (lepidoptera: noctuidae) (punjab, haryana, himanchal pradesh)
Semi looper: trichoplusia ni hübner (lepidoptera: noctuidae) (haryana, himanchal pradesh)

Diseases

Potato spotted wilt virus (karnataka)
Charcoal rot: macrophomina phaseolina (tassi) goid. (himachal pradesh, delhi, bihar, , assam, central provinces, punjab, uttar pradesh)
Potato spindle tuber viroid (pstvd) (himachal pradesh, bihar)
Pink rot: phytophthora erythroseptica pethybr. (himachal pradesh)
Soft rot: erwinia carotovora winslow (delhi)
Black heart (disorder): acute oxygen deficiency

Nematodes

Golden nematode: globodera rostochinensis (wollenweber) ()
Potato cyst nematode: globodera pallida (stone) (tamil nadu, kerala)

Rodent

Indian porcupine: hystrix indica kerr

Ipm for potato

To know the ipm practices for potato, .

Source: , and 

